r = 15; c = 15

TTTTTTTTTTTTTTT
T.............T
T.............T
T.L..++.....O.T
T.............T
T......+......T
T.............T
T.............T
T........++...T
T..+..........T
T....+........T
T.............T
T.............T
T........+....T
TTTTTTTTTTTTTTT