r = 9; c = 13

TTTTTTTTTTTTT
T...........T
T.TTTTTTT...T
T.T+....T.L.T
T.T.TTT.T...T
T.T.T+T.T...T
T...T.T.....T
T.x.....+..OT
TTTTTTTTTTTTT