r = 5; c = 14

TTTTTTTTTTTTTT
T............T
T.L....++~~+OT
T............T
TTTTTTTTTTTTTT