r = 16; c = 18

TTTTTTTTTTTTTTTTTT
T................T
T.*..............T
T.TTTTTTTTTTTTTT.T
T.T............T.T
T.T.~~~~~~~~~~.T.T
T.T.~........~.T.T
T.T.~.RRRRRR.~.T.T
T.T.~.R++L+R.~.T.T
T.T.~.R++O+R.~.T.T
T.T.~.RRRRRR.~.T.T
T.T.~........~.T.T
T.T.~~~~~~~~~~.T.T
T.T............T.T
T.TTTTTTTTTTTTTT.T
TTTTTTTTTTTTTTTTTT