r = 10; c = 12

TTTTTTTTTTTT
T..........T
T.L........T
T..RR......T
T..RR..~~~.T
T......~~~.T
T..++..~~~.T
T..++......T
T..........T
TTTTTTTTTTTT