r = 13; c = 13

TTTTTTTTTTTTT
T...........T
T.TTTTTTTTT.T
T.T.......T.T
T.T.~~~~~.T.T
T.T.~+++~.T.T
T.T.~+L+~.T.T
T.T.~+R+~.T.T
T.T.~~~~~.T.T
T.T.......T.T
T.TTTTxTTTT.T
T...........T
TTTTTTTTTTTTT