r = 11; c = 11

TTTTTTTTTTT
T.........T
T.~~~~~~~.T
T.~.....~.T
T.~.L.+.~.T
T.~.....~.T
T.~.R.R.~.T
T.~.....~.T
T.~~~~~~~.T
T....+....T
TTTTTTTTTTT