r = 5; c = 10

TTTTTTTTTT
T........T
T..L...O.T
T..++....T
TTTTTTTTTT