11 16
TTTTTTTTTTTTTTTT
T+..~~..T+T....T
T..~~...TTT....T
T..~~..........T
T.R~~.....*TTT.T
T.R~~......TxT.T
T..~~R~~~..T+T.T
T..~~~~~~~.TTT+T
T..~~+~~~......T
TL.~~~~~~~~~...T
TTTTTTTTTTTTTTTT