r = 15; c = 14
TTTTTTTTTTTTTT
T............T
T.L....++~~+.T
T............T
TTTTTTTTTTTTTT